XXXXXXXXXXXXXXXXXXXXXXXXXXX
XppppppppppppXppppppppppppX
XpXXXXpXXXXXpXpXXXXXpXXXXpX
XPXXXXpXXXXXpXpXXXXXpXXXXPX
XpXXXXpXXXXXpXpXXXXXpXXXXpX
XpppppppppppppppppppppppppX
XpXXXXpXXpXXXXXXXpXXpXXXXpX
XpXXXXpXXpXXXXXXXpXXpXXXXpX
XppppppXXppppXppppXXppppppX
XXXXXXpXXXXX X XXXXXpXXXXXX
XXXXXXpXXXXX X XXXXXpXXXXXX
XXXXXXpXX    G    XXpXXXXXX
XXXXXXpXX XXXdXXX XXpXXXXXX
XXXXXXp   XG G GX   pXXXXXX
XXXXXXpXX XXXXXXX XXpXXXXXX
XXXXXXpXX    P    XXpXXXXXX
XXXXXXpXXXXX X XXXXXpXXXXXX
XXXXXXpXXXXX X XXXXXpXXXXXX
XppppppXXppppXppppXXppppppX
XpXXXXpXXpXXXXXXXpXXpXXXXpX
XpXXXXpXXpXXXXXXXpXXpXXXXpX
XppppppppppppCppppppppppppX
XpXXXXpXXXXXpXpXXXXXpXXXXpX
XPXXXXpXXXXXpXpXXXXXpXXXXPX
XpXXXXpXXXXXpXpXXXXXpXXXXpX
XppppppppppppXppppppppppppX
XXXXXXXXXXXXXXXXXXXXXXXXXXX